8-Bit: Penny | Brock | Squeak | Piper
Amber: Piper | Belle | Carl | Crow | Pam
Angelo: Kit | Max | Nani| Mr. P
Ash: Antitank | Rosa | Frank | Bull
Barley: Assasin | Mico | Kenji | Edgar | Mortis | Ollie | Finx
Bea: Thrower | Piper | Nani | Mandy | Mr. P | Finx
Belle: Nani | Darryl | Piper | Finx| Mr. P
Berry: Assasin | Barley | Kenji | Mortis
Bibi: Surge | El Primo | Cordelius | Shelly
Bo: Sniper | Piper | Stu | Max | Leon
Bonnie: Piper | Darryl | R-T | Collete
Brock: Max | Nani | Piper | Mandy | Finx
Bull: Nita | Antitank | Hank
Buster: Rosa | Darryl | Jacky | Buzz | El Primo
Buzz: Surge | Gale | Jacky | Ollie | Finx
Byron: Piper | Nani | Mandy | Sprout | Clancy | Lou| Mr. P
Carl: Buzz | Surge | Darryl | Jacky | Gene
Charlie: Penny | Larry | Juju
Chester: Janet | Amber | Stu | Gale
Chuck: Cordelius | Angelo | Clancy | Melodie | Ollie
Clancy: Belle | Tara | Penny
Collete: Belle | Stu | Bea | Griff | Jessie
Colt: Piper | Belle | Gus | Nani | Stu | Max | Mortis | Finx
Cordelius: Frank | Buster | Surge | Nita
Crow: Piper | Spike | Tank | Finx
Darryl: Cordelius | Otis | Clancy | Ollie | Finx | Hank
Doug: Frank | Clancy | Griff
Draco: Lou | Nita | Frank
Dynamike: Mico | Mortis | Kenji | Edgar | Ollie | Finx
Edgar: Surge | Doug | Jacky | Shelly | Finx
El Primo: Cordelius | Gale | Shelly | Hank
Emz: Mortis | Barley | Juju | Larry | Janet
Eve: Piper | Penny | Janet | Max
Fang: Clancy | Otis | Shelly | Gale | Finx
Frank: Antitank | Primo | Ollie
Gale: Janet | Amber | Thrower | Penny
Gene: Mr. P | Penny | Tara | Eve | Charlie | Belle
Gray: Mr. P | Charlie | Gus | Ollie
Griff: Lola | Stu | Bea
Grom: Mico | Mortis | Assasin
Gus: Piper | Mr. P | Darryl
Hank: Dynamike | Frank | Shelly | Bibi | Buster | Buzz | Ash | Gale | Shade | Bea | Mortis | Colette
Jacky: Frank | Gale | Rosa
Janet: Frank | Carl | Kenji | Belle
Jessie: Thrower | Belle | Squeak
Juju: Frank | Tick | Larry | Wallbreaker
Kenji: Frank | Draco | Primo
Kit: Charlie | Cordelius | R-T | Chester
Larry: Tick | Edgar | Kenji | Ollie
Leon: Crow | Stu | Pearl | Finx
Lily: R-T | Jacky | Bull | Shelly
Lola: Belle | Penny | Amber
Lou: Belle | Bea | Bo | Poco | Thrower
Maisie: Barley | Stu | Belle | Penny
Mandy: Nani | Tick | Mortis | Thrower
Max: Crow | Gus | Pam | Stu | Finx
Meeple: Kenji | Frank | Ash| Mr. P
Meg: Collete | Lou | Lola | Bea
Melodie: Clancy | Cordelius | Buzz
Mico: R-T | Bull | Stu
Moe: Penny | Darryl | Larry
Mortis: Jacky | Shade | Bull | Gale | Shelly | Ollie | Finx
Mr. P: Edgar | Mortis | Bibi | Ollie
Nani: Gene | Max | Darryl | Tick
Nita: Larry | Barley | Juju | Willow | Spike | Griff
Otis: Barley | Juju | Larry | Stu | Amber
Pam: Jessie | Lou | 8-Bit | Collete
Pearl: Lou | 8-Bit | Buster
Penny: Thrower | Squeak | Kenji | Bo | Hank
Piper: Nani | Tick | Kit | Kenji | Finx | Hank
Poco: Emz | Mortis | Jessie
R-T: Thrower | Gus | Max | Bo
Rico: Thrower | Brock | Piper | Stu
Rosa: Emz | Frank | Antitank
Ruffs: Buzz | Carl | Sprout | Assasin | Finx
Sam: Surge | Lou | Griff
Sandy: Nita | Janet | Kenji | Larry
Shade: Frank | Lou | Jacky
Shelly: Stu | Nita | Spike | Penny | Otis | Ollie
Spike: Thrower | Squeak | Carl | Piper
Sprout: Mico | Mortis | Edgar | Frank | Ollie | Finx
Squeak: Assasin | Ash
Stu: Healer | Sniper | Ruffs | Penny | Sandy
Surge: Thrower | Ruffs | Tara | Charlie | Spike
Tara: Thrower | Otis | Sandy | Janet | Ollie
Tick: Mico | Mortis | Darryl | Bibi | Ollie | Finx
Willow: Barley | Larry | Buzz | Ollie
Ollie: Poco | Buster | Leon | Crow | Shelly
Finx: Buster | Mandy | Spike | Shelly | Max | Surge | Griff | Gale | Otis | Chester